WWWWWWWWWWWWWWWWWWWWWWWWW
WP SSS    SSSSSS        W
W W WSW WSWSW WSWSWSW W W
WS  SS ES E    SSS   E  W
WSW W W WSW WSWSW W WSW W
W E   S   S S E SS S    W
W W W W W W WSW W W WSW W
W   SSS   S     SS  SSS W
W W W WSW W W W WSW W W W
WSS      SSS     SSS   EW
WSWSWSWSWSW W W W W W W W
W    SS SS    SS S  S S W
W W W W W W W WSWSWSW W W
WSSS     E  SS    E   S W
WWWWWWWWWWWWWWWWWWWWWWWWW